SO ./textures/south_wall.xpm

EA ./textures/east_wall.xpm

NO ./textures/north_wall.xpm

WE  ./textures/north_wall.xpm

C 0      ,0 ,0    
F 0,0,0









111111111           111111111111   
 11                      1
110111111111111111111111101
100000S11 1111100001     1
111111111    1111111111








