SO ./textures/south_wall.xpm

EA ./textures/east_wall.xpm

NO ./textures/north_wall.xpm

WE ./textures/west_wall.xpm

F 0, 0, 0
C 0, 0, 0










111111111
11011111
100W00011
1111100001
111111111
