SO ./textures/south_wall.xpm

EA ./textures/east_wall.xpm

NO ./textures/north_wall.xpm

WE ./textures/west_wall.xpm

F 55, 55, 55
C 55, 55, 55



111111111           111111111111
111111111           111111111111
110111111111111111111111101
1000D0S11 1111100001     1
111111111    1111111111
111111111    1111111111








