SO ./textures/souh_wall.xpm

EA ./textures/east_wall.xpm

NO ./textures/north_wall.xpm

WE ./textures/west_wall.xpm

F 55, 55, 55
C 55, 55, 55



1111111111111111111111111111     11
1000001D11111000000000001 101   101
101100001110000000000001 111     1
10010000000000101111000011111111111111111111111111111
11111111101100000111001000001000000001000000000000001
1000000000110000011101111110111111111111100000D000001
11110111111101011100D00010001           1D000D0D00001
11110100000001011101010010001           101000D0000W1
11000000110000011100000010001            11111111111
100000000000000000000000000011	
1000000000000000010101001000111
110000011101010111100111100011
11110111 1110101 101111010001
11111111 1111111 11111111111